NO ./textures/ab.png
SO ./textures/loculy.png
WE ./textures/fsg.png
EA ./textures/iip.png
DO ./textures/op.png


F 110,220,255
C  19 , 175,42

        1111111111111111111111111
        1000000000110000000000001
        1011000001110000000000001
        1001000000000000000000001
        1111111D111111111D1111111
111111111011000001110000000000001
10000000001100000111011111D111111
11110111111111011100000010001
11110111111111011101010010001
11000000110101011100000010001
100000000000000011000000100011
100000000000000011010100100001
11000001110101011111011110N011
11110111 1110101 101111010001
11111111 1111111 111111111111